// Useful for library class later on.
as = Askim
ba = Backa
bs = Bergsjön
bi = Biskopsgården
bussa = Bokbuss Tur A
bussb = Bokbuss Tur B
do = Donsö
dy = Dynamo på Stadsmuseet
ga = Gamlestaden
in = Global på Stadsmuseet
gu = Guldheden
ha = Hammarkullen
hi = Hisingen
hj = Hjällbo
hl = Härlanda/Örgryte
ho = Högsbo
ko = Kortedala
ky = Kyrkbyn
ka = Kärra
li = Linnéstaden
ma = Majorna
mi = Miini på Röhsska
st = Styrsö
to = Torslanda
tr = Trulsegården
tu = Tuve
vf = Västra Frölunda
al = Älvstranden
ci = 300m2 på Södra Hamng